w                               w
w               s               w
w               w               w
w            w     w            w
w         w     w     w         w
w      w     w     w     w      w
w   w     w     w     w     w   w
ww     w     w     w     w     ww
w   w     w     w     w     w   w
ww     w     w     w     w     ww
w   w     w     w     w     w   w
ww     w     w     w     w     ww
w   w     w     w     w     w   w
ww     w     w     w     w     ww
w   w     w     w     w     w   w
ww     w     w     w     w     ww
weeeeeeeeeeeeeeeeeeeeeeeeeeeeeeew
wwwwwwwwwwwwwwwwwwwwwwwwwwwwwwwww
