wwwwwwwwwwwwwwwwwwwwwwwwwwwwwwwww
w               s               w
w              www              w
w         www       www         w
w    www       www       www    w
www        w         w        www
w    www        w        www    w
w         www       www         w
w    www       www       www    w
www                           www
ww w w w w w w w w w w w w w w ww
www        w         w        www
w    www        w        www    w
w         www       www         w
w    www       www       www    w
www                           www
weeeeeeeeeeeeeeeeeeeeeeeeeeeeeeew
wwwwwwwwwwwwwwwwwwwwwwwwwwwwwwwww
