wwwwwwwwwwwwwwwwwwwwwwwwwwwwwwwww
w     w         w               w
w     w         w           w   w
w     w         w          w    w
w     w         w         w     w
w     w         w        w      w
w     w         w       w       w
w     w         w      w        w
w     w         w     w         w
w     w     w   w    w          w
w     w    w    w   w           w
w     w   w        w            w
w        w      www             w
w  s  www    w  w               w
w  w         w  w w             w
wwwwwww      ww   ww            w
wwwwwwwwwwwwwwwwwwwwwwwwwwwwwwwww
