w                               w
w                               w
w                               w
w                               w
w                               e
w                               e
w                               e
w                      wwwwwwwwww
w             wwwwww            w
ww      www                     w
www                             w
w   ww    www                   w
wwww               www          w
w     ww                 www    w
w                               w
w                 wwww          w
w              s                w
wwwwwwwwwwwwwwwwwwwwwwwwwwwwwwwww
