wwwwwwwwwwwwwwwwwwwwwwwwwwwwwwwww
w     w         w               w
w     w         w           w   w
w     w         w          w    w
w     w         w         w     e
w     w         w        w      e
w     w         w       w       e
w     w         w      w        w
w     w         w     w         w
w     w     w   w    w          w
w     w    w    w   w           w
w     w   w        w            w
w        w      www             w
w     www       w               w
w  s  w         w               w
w  w  w         w               w
wwwwwwwwwwwwwwwwwwwwwwwwwwwwwwwww
