wwwwwwwwwwwwwwwwwwwwwwwwwwwwwwww
w                              w
w                              w
w                              w
w                              w
w                              w
w                              w
w                              w
w s                            w
wwww  w                        w
wwww  ww   wwww                w
wwww  ww    ww                 w
wwww  ww    ww         ww      w
www   w     w           w      w
www   w     w           w      w
ww    w     w           w      w
ww    w     w           w      w
ww    w     w           w     ww
